1111111111111111111111111111111111111
10000000000000000000000000000000000C1
10E0000000000111111101111111111111001
100000000011111111C001111000111111001
100000001111111PC00001010C00111111001
1000011111111C00000001000000111111001
1001111111C00000000000000110111110001
10000000C0000000000000000000000000001
10110100CCCCC0CCCCCC01111111000000001
1011011111111111111101111111000001001
1011011111111111111101111111000110001
1011011111111111111101111111011111001
100C000000000111111100000000000000001
100000000000011111110110000C000000001
1000000000000000000001111101011110001
10000C000000011111110000000C000000001
1111111111111111111111111111111111111