11111111111111111111
10000C0000C00000C001
1011111111111C000001
1P1E0000C0000000C001
11111111111111111111