11111111
1qasdP11
12311111
11111111